"Nr OKW";"Kod TERYT";"Powiat";"Województwo";"Komisje obwodowe otrzymały kart do głosowania";"Liczba wyborców uprawnionych do głosowania";"Nie wykorzystano kart do głosowania";"Liczba wyborców, którym wydano karty do głosowania";"Liczba wyborców głosujących przez pełnomocnika";"Liczba wyborców głosujących na podstawie zaświadczenia o prawie do głosowania";"Liczba wyborców, którym wysłano pakiety wyborcze";"Liczba otrzymanych kopert zwrotnych";"Liczba kopert zwrotnych, w których nie było oświadczenia o osobistym i tajnym oddaniu głosu";"Liczba kopert zwrotnych, w których oświadczenie nie było podpisane";"Liczba kopert zwrotnych, w których nie było koperty na kartę do głosowania";"Liczba kopert zwrotnych, w których znajdowała się niezaklejona koperta na kartę do głosowania";"Liczba kopert na kartę do głosowania wrzuconych do urny";"Liczba kart wyjętych z urny";"W tym liczba kart wyjętych z kopert na kartę do głosowania";"Liczba kart nieważnych";"Liczba kart ważnych";"Liczba głosów nieważnych";"W tym z powodu postawienia znaku „X” obok nazwiska dwóch lub większej liczby kandydatów";"W tym z powodu niepostawienia znaku „X” obok nazwiska żadnego kandydata";"W tym z powodu postawienia znaku „X” wyłącznie obok skreślonego nazwiska kandydata";"Liczba głosów ważnych oddanych łącznie na wszystkich kandydatów";"Andrzej Sebastian DUDA";"Rafał Kazimierz TRZASKOWSKI";"Liczba obwodów"
2;"020100";"bolesławiecki";"dolnośląskie";63867;67800;21631;42238;13;633;356;342;6;0;1;1;335;42570;334;1;42569;322;179;143;"";42247;20966;21281;63
4;"020200";"dzierżoniowski";"dolnośląskie";73104;77836;24749;48353;54;878;441;423;9;1;3;2;408;48759;408;4;48755;413;235;178;"";48342;24383;23959;83
3;"020300";"głogowski";"dolnośląskie";63362;66323;19393;43970;20;719;309;298;12;2;0;0;284;44251;284;9;44242;363;231;132;"";43879;22722;21157;53
1;"020400";"górowski";"dolnośląskie";24371;26736;8679;15692;21;210;170;167;4;0;0;0;163;15853;163;0;15853;138;68;70;"";15715;8957;6758;23
2;"020500";"jaworski";"dolnośląskie";36822;39507;12316;24506;38;411;292;286;10;0;1;2;273;24777;273;0;24777;240;135;105;"";24537;13358;11179;39
2;"020600";"jeleniogórski";"dolnośląskie";48440;54592;12163;36278;42;4957;384;377;2;0;1;0;374;36653;374;2;36651;295;175;120;"";36356;13131;23225;53
2;"020700";"kamiennogórski";"dolnośląskie";32045;33809;11148;20896;30;413;157;149;5;0;0;0;144;21040;144;5;21035;169;93;76;"";20866;9920;10946;32
4;"020800";"kłodzki";"dolnośląskie";117617;129045;37438;80179;102;5950;862;817;18;3;5;0;791;80967;791;12;80955;647;352;295;"";80308;37276;43032;137
3;"020900";"legnicki";"dolnośląskie";38871;41869;11613;27258;25;441;211;197;6;0;3;1;188;27445;188;0;27445;236;128;108;"";27209;15259;11950;45
2;"021000";"lubański";"dolnośląskie";40084;43150;13306;26778;11;1202;214;203;13;0;0;0;190;26967;189;0;26967;245;119;126;"";26722;12096;14626;41
3;"021100";"lubiński";"dolnośląskie";75693;79505;22795;52898;25;851;388;367;10;0;3;0;354;53247;354;2;53245;414;236;178;"";52831;29704;23127;75
2;"021200";"lwówecki";"dolnośląskie";33497;35812;12255;21242;43;651;189;182;1;1;1;1;178;21419;177;2;21417;183;85;98;"";21234;10206;11028;39
1;"021300";"milicki";"dolnośląskie";26345;28856;7997;18348;15;288;155;152;2;0;0;0;150;18498;150;1;18497;125;69;56;"";18372;10153;8219;27
1;"021400";"oleśnicki";"dolnośląskie";75305;81819;22463;52853;25;866;576;555;11;4;7;0;533;53385;533;2;53383;398;210;188;"";52985;25524;27461;66
1;"021500";"oławski";"dolnośląskie";53885;58184;13888;39995;41;536;355;346;8;1;12;0;325;40325;325;1;40324;321;180;141;"";40003;19825;20178;51
3;"021600";"polkowicki";"dolnośląskie";44140;46926;13920;30239;58;511;197;188;5;0;2;0;181;30419;181;0;30419;295;178;117;"";30124;18597;11527;43
1;"021700";"strzeliński";"dolnośląskie";32342;35011;9394;22948;26;331;254;249;3;0;0;0;246;23194;246;0;23194;165;92;73;"";23029;13199;9830;39
1;"021800";"średzki";"dolnośląskie";38880;42361;10900;27979;19;482;277;268;5;0;0;1;262;28241;262;2;28239;252;133;119;"";27987;14656;13331;36
4;"021900";"świdnicki";"dolnośląskie";113359;120298;35823;77535;88;1230;746;699;13;4;11;0;671;78206;671;1;78205;629;336;293;"";77576;36334;41242;107
1;"022000";"trzebnicki";"dolnośląskie";60655;65963;15748;44907;34;827;396;382;5;0;0;0;377;45269;377;1;45268;363;188;175;"";44905;22627;22278;60
4;"022100";"wałbrzyski";"dolnośląskie";40984;43390;14245;26738;44;907;286;271;4;0;0;0;267;27004;267;8;26996;224;122;102;"";26772;11265;15507;50
1;"022200";"wołowski";"dolnośląskie";35155;37493;11228;23924;19;322;178;172;3;0;0;0;169;24091;169;0;24091;212;102;110;"";23879;12847;11032;33
1;"022300";"wrocławski";"dolnośląskie";103434;114486;18946;84465;58;2255;962;930;20;0;5;0;905;85380;905;25;85355;847;525;322;"";84508;35366;49142;85
4;"022400";"ząbkowicki";"dolnośląskie";47852;51235;16387;31465;69;685;337;324;2;0;2;3;317;31778;317;1;31777;235;130;105;"";31542;17141;14401;73
2;"022500";"zgorzelecki";"dolnośląskie";64820;69163;21895;42919;45;1137;354;340;17;0;0;0;323;43241;323;4;43237;371;208;163;"";42866;20352;22514;82
2;"022600";"złotoryjski";"dolnośląskie";32109;33719;11074;21045;28;372;146;145;0;0;0;1;144;21188;144;1;21187;173;86;87;"";21014;10788;10226;43
2;"026100";"Jelenia Góra";"dolnośląskie";57198;60866;16799;40401;21;1454;388;368;10;0;2;0;356;40755;356;2;40753;308;201;107;"";40445;14403;26042;47
3;"026200";"Legnica";"dolnośląskie";68620;72273;21784;46816;18;759;417;390;8;4;7;0;371;47184;371;1;47183;353;200;153;"";46830;21190;25640;49
1;"026400";"Wrocław";"dolnośląskie";444281;501319;79842;364567;262;10476;4878;4537;54;4;6;21;4470;368995;4471;62;368933;3588;2250;1338;"";365345;121958;243387;312
4;"026500";"Wałbrzych";"dolnośląskie";78104;81030;28492;49609;40;773;371;354;6;0;4;0;344;49947;344;6;49941;429;248;181;"";49512;19628;29884;61
7;"040100";"aleksandrowski";"kujawsko-pomorskie";41595;45431;11970;29625;38;2090;288;281;6;0;0;1;274;29898;274;0;29898;241;150;91;"";29657;16198;13459;56
6;"040200";"brodnicki";"kujawsko-pomorskie";56112;60724;17739;38372;38;1127;290;282;17;1;1;0;263;38634;263;2;38632;315;190;125;"";38317;21478;16839;59
5;"040300";"bydgoski";"kujawsko-pomorskie";82992;89345;21320;61671;72;1343;526;509;14;1;1;1;493;62156;493;0;62156;492;291;201;"";61664;24536;37128;103
6;"040400";"chełmiński";"kujawsko-pomorskie";36261;38321;12960;23294;26;287;193;182;4;1;0;0;177;23470;177;1;23469;219;105;114;"";23250;11618;11632;47
6;"040500";"golubsko-dobrzyński";"kujawsko-pomorskie";32701;35036;11118;21583;38;313;155;153;6;0;0;0;147;21731;147;2;21729;161;92;69;"";21568;12907;8661;32
6;"040600";"grudziądzki";"kujawsko-pomorskie";28577;30558;10500;18077;17;184;125;125;4;0;1;1;119;18195;119;0;18195;153;73;80;"";18042;10350;7692;42
5;"040700";"inowrocławski";"kujawsko-pomorskie";115916;124249;37404;78525;79;1467;619;601;2;2;4;0;593;79091;593;4;79087;581;339;242;"";78506;36641;41865;141
7;"040800";"lipnowski";"kujawsko-pomorskie";46527;51610;16359;30168;47;584;252;244;4;0;3;1;236;30403;236;0;30403;241;130;111;"";30162;18164;11998;68
5;"040900";"mogileński";"kujawsko-pomorskie";33436;36264;10991;22445;15;408;124;121;2;0;0;0;119;22564;119;2;22562;164;116;48;"";22398;11926;10472;41
5;"041000";"nakielski";"kujawsko-pomorskie";61356;65229;20622;40733;29;582;302;292;16;2;0;0;274;41005;274;0;41005;330;190;140;"";40675;20058;20617;78
7;"041100";"radziejowski";"kujawsko-pomorskie";30758;33286;9909;20860;60;700;172;167;0;0;0;0;167;21026;167;0;21026;150;95;55;"";20876;13477;7399;51
7;"041200";"rypiński";"kujawsko-pomorskie";31620;34170;10685;20935;52;456;155;147;12;0;5;0;130;21064;130;0;21064;138;65;73;"";20926;12569;8357;45
5;"041300";"sępoleński";"kujawsko-pomorskie";29289;31132;10292;18997;37;422;97;92;2;0;0;0;90;19087;90;0;19087;104;66;38;"";18983;9882;9101;42
5;"041400";"świecki";"kujawsko-pomorskie";70375;75066;24229;46146;69;919;301;292;3;2;0;0;287;46433;287;1;46432;354;202;152;"";46078;23411;22667;91
6;"041500";"toruński";"kujawsko-pomorskie";75361;80713;22478;52883;42;750;510;496;19;0;3;0;474;53353;474;3;53350;435;239;196;"";52915;25117;27798;70
5;"041600";"tucholski";"kujawsko-pomorskie";34540;38000;10048;24492;34;1044;200;191;6;0;1;0;184;24674;184;0;24674;222;134;88;"";24452;13980;10472;51
6;"041700";"wąbrzeski";"kujawsko-pomorskie";24494;26062;9057;15437;29;189;105;104;3;0;0;0;101;15538;101;0;15538;123;71;52;"";15415;7935;7480;29
7;"041800";"włocławski";"kujawsko-pomorskie";62824;69407;19798;43026;93;1480;368;359;12;0;3;0;344;43370;344;1;43369;348;185;163;"";43021;25230;17791;80
5;"041900";"żniński";"kujawsko-pomorskie";50213;54278;15972;34241;45;680;259;253;4;0;0;1;248;34489;248;0;34489;309;204;105;"";34180;17762;16418;77
5;"046100";"Bydgoszcz";"kujawsko-pomorskie";241623;255625;63978;177645;40;3100;1780;1713;19;1;8;1;1685;179325;1685;6;179319;1462;926;536;"";177857;66131;111726;204
6;"046200";"Grudziądz";"kujawsko-pomorskie";64270;67400;21564;42706;19;571;286;277;2;0;0;0;275;42981;275;2;42979;341;207;134;"";42638;17782;24856;55
6;"046300";"Toruń";"kujawsko-pomorskie";136357;147733;32617;103739;39;2145;1089;1052;24;2;3;0;1023;104759;1023;7;104752;853;527;326;"";103899;38332;65567;123
7;"046400";"Włocławek";"kujawsko-pomorskie";79008;83294;25265;53744;43;853;409;392;3;0;4;0;385;54130;385;3;54127;406;216;190;"";53721;21244;32477;68
9;"060100";"bialski";"lubelskie";81237;87609;26382;54858;124;1140;1034;1001;33;1;11;0;956;55815;956;1;55814;538;285;253;"";55276;38924;16352;115
11;"060200";"biłgorajski";"lubelskie";75494;80984;22829;52665;239;1003;418;410;13;1;0;0;396;53059;396;0;53059;454;219;235;"";52605;39532;13073;99
10;"060300";"chełmski";"lubelskie";57546;62527;21064;36482;87;604;427;413;5;0;7;1;400;36882;400;0;36882;314;162;152;"";36568;26523;10045;90
11;"060400";"hrubieszowski";"lubelskie";48517;51809;18377;30140;83;692;240;235;13;1;0;0;221;30360;221;0;30360;182;74;108;"";30178;21601;8577;69
8;"060500";"janowski";"lubelskie";34409;36801;8603;25808;182;321;334;325;14;0;5;0;306;26114;306;0;26114;231;133;98;"";25883;21795;4088;38
10;"060600";"krasnostawski";"lubelskie";48865;52360;17221;31644;66;438;487;473;8;0;3;2;460;32099;460;2;32097;258;139;119;"";31839;22100;9739;90
8;"060700";"kraśnicki";"lubelskie";70683;75402;21722;48960;154;635;459;444;7;0;0;0;437;49395;437;6;49389;493;298;195;"";48896;35542;13354;86
8;"060800";"lubartowski";"lubelskie";64839;70086;17992;46847;142;859;364;358;6;0;2;1;349;47194;349;0;47194;486;250;236;"";46708;33693;13015;91
8;"060900";"lubelski";"lubelskie";111461;121756;28069;83380;121;1051;917;890;9;0;3;3;875;84253;875;7;84246;892;526;366;"";83354;56890;26464;129
8;"061000";"łęczyński";"lubelskie";40625;44143;11641;28986;22;551;273;265;4;0;0;1;260;29246;260;1;29245;252;140;112;"";28993;20528;8465;53
8;"061100";"łukowski";"lubelskie";76818;82375;19578;57240;94;832;443;431;11;2;4;0;415;57653;415;0;57653;535;275;260;"";57118;44231;12887;98
8;"061200";"opolski";"lubelskie";44475;47984;13870;30605;40;618;260;256;13;0;0;0;243;30848;243;1;30847;251;110;141;"";30596;22414;8182;62
9;"061300";"parczewski";"lubelskie";26178;28358;8216;17963;58;602;93;89;1;0;0;0;88;18050;88;1;18049;141;79;62;"";17908;12228;5680;38
8;"061400";"puławski";"lubelskie";85378;91520;22945;62447;131;2217;761;735;19;0;2;0;714;63133;712;17;63116;653;370;283;"";62463;38844;23619;97
9;"061500";"radzyński";"lubelskie";43188;47193;12702;30486;66;458;183;179;7;2;0;0;170;30654;170;0;30654;319;196;123;"";30335;22736;7599;55
8;"061600";"rycki";"lubelskie";41245;44301;10717;30538;44;545;272;266;6;2;0;0;258;30794;258;0;30794;271;143;128;"";30523;21319;9204;69
8;"061700";"świdnicki";"lubelskie";52514;56029;15306;37208;49;451;463;446;6;1;0;0;439;37647;439;1;37646;340;189;151;"";37306;24088;13218;53
11;"061800";"tomaszowski";"lubelskie";63235;68062;22124;41111;127;1063;498;492;13;0;5;0;474;41584;474;0;41584;350;202;148;"";41234;30349;10885;100
10;"061900";"włodawski";"lubelskie";29958;32637;9170;20788;28;1350;182;179;2;0;0;0;177;20965;177;1;20964;205;113;92;"";20759;12612;8147;47
11;"062000";"zamojski";"lubelskie";80800;87992;24802;55998;202;1953;653;629;13;0;1;2;613;56608;613;0;56608;487;267;220;"";56121;42139;13982;119
9;"066100";"Biała Podlaska";"lubelskie";41840;43771;13081;28751;26;525;297;289;6;0;1;1;281;29026;280;2;29024;284;171;113;"";28740;16160;12580;29
10;"066200";"Chełm";"lubelskie";46645;48686;16234;30411;15;497;266;259;0;1;0;0;258;30669;258;1;30668;273;181;92;"";30395;16196;14199;36
8;"066300";"Lublin";"lubelskie";240661;259924;62597;178061;111;3331;2390;2286;35;1;4;4;2245;180298;2245;11;180287;1698;1037;661;"";178589;87087;91502;208
11;"066400";"Zamość";"lubelskie";46941;49350;15241;31700;26;856;290;266;5;0;5;0;256;31953;256;0;31953;257;161;96;"";31696;17922;13774;35
13;"080100";"gorzowski";"lubuskie";50431;54187;14924;35507;19;681;216;209;9;0;1;0;199;35704;199;2;35702;311;156;155;"";35391;14092;21299;61
12;"080200";"krośnieński";"lubuskie";39678;42336;13583;26095;27;532;256;250;6;1;1;0;242;26335;242;0;26335;185;85;100;"";26150;10339;15811;50
13;"080300";"międzyrzecki";"lubuskie";41884;46410;12420;29464;28;1175;400;381;5;1;5;0;370;29834;370;0;29834;239;123;116;"";29595;12079;17516;55
12;"080400";"nowosolski";"lubuskie";60958;65374;19289;41669;48;776;343;337;22;0;0;0;315;41978;315;4;41974;315;173;142;"";41659;18506;23153;53
13;"080500";"słubicki";"lubuskie";33015;35798;10296;22717;22;759;138;133;1;0;0;0;132;22848;132;3;22845;160;74;86;"";22685;8756;13929;35
13;"080600";"strzelecko-drezdenecki";"lubuskie";35393;38733;11916;23487;26;810;151;144;1;0;2;0;141;23626;141;0;23626;180;100;80;"";23446;10585;12861;40
13;"080700";"sulęciński";"lubuskie";25180;27433;8099;17081;32;517;90;86;1;0;0;0;85;17163;85;0;17163;131;79;52;"";17032;7968;9064;36
12;"080800";"świebodziński";"lubuskie";40042;43548;12076;27971;13;1055;188;183;5;0;1;1;176;28147;176;1;28146;238;137;101;"";27908;11450;16458;39
12;"080900";"zielonogórski";"lubuskie";54437;58070;16775;37662;41;773;259;245;4;1;2;1;237;37892;237;0;37892;285;132;153;"";37607;14924;22683;51
12;"081000";"żagański";"lubuskie";55696;60031;19316;36380;48;596;304;293;18;7;0;2;269;36646;269;0;36646;273;148;125;"";36373;16843;19530;57
12;"081100";"żarski";"lubuskie";69338;73286;24888;44449;35;754;329;308;9;0;3;0;296;44742;296;0;44742;319;173;146;"";44423;18415;26008;67
12;"081200";"wschowski";"lubuskie";27734;30574;8582;19173;7;875;162;157;14;0;2;0;141;19310;141;17;19293;147;88;59;"";19146;10168;8978;32
13;"086100";"Gorzów Wielkopolski";"lubuskie";87019;90649;26330;60685;31;1052;416;398;11;0;3;2;382;61055;383;3;61052;485;269;216;"";60567;22330;38237;68
12;"086200";"Zielona Góra";"lubuskie";97903;103880;23421;74491;58;1604;646;624;17;3;0;3;601;75084;601;8;75076;620;341;279;"";74456;23134;51322;76
15;"100100";"bełchatowski";"łódzkie";81977;87411;20845;61130;92;1010;454;441;19;1;4;1;416;61540;416;5;61535;657;420;237;"";60878;41128;19750;72
14;"100200";"kutnowski";"łódzkie";72143;76663;22020;50124;88;749;471;454;7;1;1;0;445;50568;445;6;50562;431;235;196;"";50131;30888;19243;83
14;"100300";"łaski";"łódzkie";36750;40165;9098;27660;29;513;258;254;1;0;0;0;253;27913;253;0;27913;272;168;104;"";27641;16421;11220;39
14;"100400";"łęczycki";"łódzkie";38103;40869;11523;26580;31;290;228;224;5;0;0;0;219;26797;219;1;26796;232;116;116;"";26564;17968;8596;49
14;"100500";"łowicki";"łódzkie";58166;62772;15054;43112;28;543;368;361;5;0;1;0;355;43466;355;1;43465;434;219;215;"";43031;28650;14381;71
14;"100600";"łódzki wschodni";"łódzkie";51933;56942;10439;41491;41;753;455;437;9;0;2;1;425;41916;425;0;41916;415;248;167;"";41501;21930;19571;77
17;"100700";"opoczyński";"łódzkie";55369;60264;12324;43045;56;680;570;557;11;0;3;0;543;43587;543;3;43584;358;209;149;"";43226;32372;10854;73
14;"100800";"pabianicki";"łódzkie";85643;92285;21104;64547;154;1072;631;595;18;0;2;2;574;65096;574;4;65092;552;304;248;"";64540;30289;34251;70
16;"100900";"pajęczański";"łódzkie";37787;41216;9961;27828;85;448;428;418;17;1;7;0;393;28218;392;5;28213;245;139;106;"";27968;19715;8253;39
15;"101000";"piotrkowski";"łódzkie";66011;73049;15005;51005;99;992;487;471;16;0;19;1;435;51438;435;11;51427;468;267;201;"";50959;37228;13731;78
14;"101100";"poddębicki";"łódzkie";30553;34023;7950;22602;13;634;195;191;3;1;0;2;185;22787;185;1;22786;187;90;97;"";22599;14498;8101;51
15;"101200";"radomszczański";"łódzkie";83838;89684;23915;59922;142;1116;539;521;5;1;5;2;508;60429;508;7;60422;481;290;191;"";59941;38063;21878;89
17;"101300";"rawski";"łódzkie";35577;38491;9241;26336;25;413;147;142;2;1;1;0;138;26473;138;5;26468;230;139;91;"";26238;18162;8076;29
16;"101400";"sieradzki";"łódzkie";86644;93034;24063;62582;44;992;803;788;18;0;5;0;765;63342;765;9;63333;597;375;222;"";62736;40882;21854;94
17;"101500";"skierniewicki";"łódzkie";27584;30280;5484;22102;41;285;200;194;1;0;1;3;189;22290;189;1;22289;295;172;123;"";21994;16455;5539;39
17;"101600";"tomaszowski";"łódzkie";84020;90508;20817;63202;44;1216;725;689;13;6;1;4;665;63864;665;3;63861;563;301;262;"";63298;38800;24498;78
16;"101700";"wieluński";"łódzkie";56476;60747;15472;41033;61;727;440;429;14;0;0;1;414;41444;414;4;41440;397;207;190;"";41043;25759;15284;80
16;"101800";"wieruszowski";"łódzkie";30242;33349;8761;21481;21;269;302;283;10;0;1;0;272;21753;272;1;21752;173;98;75;"";21579;13539;8040;38
16;"101900";"zduńskowolski";"łódzkie";45989;50859;11560;34429;26;457;310;290;5;1;1;1;282;34709;282;2;34707;286;181;105;"";34421;19944;14477;42
14;"102000";"zgierski";"łódzkie";119541;129292;28683;90860;103;1450;895;869;20;2;2;0;846;91702;846;8;91694;748;419;329;"";90946;44021;46925;121
14;"102100";"brzeziński";"łódzkie";22521;24260;5545;16976;54;247;116;113;4;0;0;0;109;17084;109;0;17084;176;96;80;"";16908;10560;6348;39
14;"106100";"Łódź";"łódzkie";491154;511975;134663;356452;189;6038;3727;3539;14;4;12;4;3506;359925;3505;48;359877;3015;1846;1169;"";356862;129082;227780;314
15;"106200";"Piotrków Trybunalski";"łódzkie";53043;55563;14836;38207;29;492;367;358;6;0;2;0;350;38553;350;0;38553;342;206;136;"";38211;19494;18717;41
17;"106300";"Skierniewice";"łódzkie";33329;36279;7465;25864;21;387;247;234;8;0;0;0;227;26090;227;3;26087;225;144;81;"";25862;12556;13306;27
20;"120100";"bocheński";"małopolskie";76144;82520;17222;58921;45;823;810;790;6;0;3;0;781;59703;781;14;59689;553;307;246;"";59136;42272;16864;76
20;"120200";"brzeski";"małopolskie";67073;72357;19081;47991;43;686;594;570;21;0;0;1;548;48535;548;3;48532;554;296;258;"";47978;35017;12961;70
18;"120300";"chrzanowski";"małopolskie";90148;96637;24493;65662;33;813;924;893;13;1;6;0;873;66526;873;3;66523;596;335;261;"";65927;33447;32480;89
20;"120400";"dąbrowski";"małopolskie";43085;46485;14876;28209;75;289;333;317;12;1;6;1;297;28504;297;14;28490;237;118;119;"";28253;22364;5889;54
19;"120500";"gorlicki";"małopolskie";78893;86663;22481;56413;61;1511;662;640;9;1;1;0;629;57037;629;6;57031;466;261;205;"";56565;39732;16833;93
18;"120600";"krakowski";"małopolskie";196212;216624;40241;155970;102;2614;2325;2240;47;2;3;2;2186;158172;2185;62;158110;1592;955;637;"";156518;91010;65508;196
19;"120700";"limanowski";"małopolskie";90917;99926;20553;70362;69;1511;1131;1120;36;0;6;1;1077;71439;1077;10;71429;587;317;270;"";70842;57003;13839;105
18;"120800";"miechowski";"małopolskie";36375;39697;10451;25928;55;400;325;316;10;2;0;1;303;26230;303;1;26229;211;103;108;"";26018;18443;7575;66
18;"120900";"myślenicki";"małopolskie";89557;97834;19038;70525;51;998;949;920;13;0;6;1;900;71427;900;13;71414;701;385;316;"";70713;49979;20734;84
19;"121000";"nowosądecki";"małopolskie";147120;167516;27668;119448;86;5568;1864;1819;37;3;11;1;1770;121207;1770;8;121199;950;524;426;"";120249;94941;25308;173
19;"121100";"nowotarski";"małopolskie";138173;152156;40515;97658;122;6382;814;800;16;2;1;2;779;98433;779;10;98423;750;385;365;"";97673;70848;26825;154
18;"121200";"olkuski";"małopolskie";81558;87427;20606;60972;77;835;650;633;3;0;0;0;630;61605;630;2;61603;538;328;210;"";61065;35814;25251;86
18;"121300";"oświęcimski";"małopolskie";110638;118755;27932;82706;77;1048;1155;1106;22;3;2;1;1078;83786;1079;5;83781;728;432;296;"";83053;45527;37526;104
18;"121400";"proszowicki";"małopolskie";31841;34638;9467;22373;58;203;176;172;0;0;0;0;172;22544;172;0;22544;147;76;71;"";22397;16602;5795;41
19;"121500";"suski";"małopolskie";60178;67024;15619;44558;28;1443;1038;1009;26;0;6;3;974;45525;974;0;45525;422;238;184;"";45103;31055;14048;61
20;"121600";"tarnowski";"małopolskie";144559;156936;41907;102650;97;1274;1598;1560;20;3;1;0;1536;104184;1536;5;104179;923;487;436;"";103256;77884;25372;151
19;"121700";"tatrzański";"małopolskie";53879;64930;8351;45527;39;10453;538;522;10;1;2;1;508;46033;509;4;46029;316;182;134;"";45713;27931;17782;54
18;"121800";"wadowicki";"małopolskie";114301;124498;28562;85739;65;1437;1073;1024;18;1;8;1;996;86735;996;5;86730;751;424;327;"";85979;53341;32638;106
18;"121900";"wielicki";"małopolskie";88621;98736;17964;70665;34;1019;860;821;11;0;2;4;804;71469;804;5;71464;682;414;268;"";70782;39977;30805;82
18;"126100";"Kraków";"małopolskie";552201;602006;114544;437803;304;11380;7011;6677;65;16;12;14;6580;444181;6581;62;444119;4373;2779;1594;"";439746;169441;270305;447
19;"126200";"Nowy Sącz";"małopolskie";59604;63371;16108;43496;18;714;551;533;5;0;1;7;520;44001;520;2;43999;432;272;160;"";43567;26101;17466;53
20;"126300";"Tarnów";"małopolskie";80849;85706;24876;55971;80;736;784;758;5;0;9;1;743;56714;742;1;56713;491;302;189;"";56222;28861;27361;74
25;"140100";"białobrzeski";"mazowieckie";23655;26684;4273;19372;44;419;142;140;12;0;0;1;127;19499;127;3;19496;177;79;98;"";19319;14544;4775;24
22;"140200";"ciechanowski";"mazowieckie";64946;70029;18215;46731;57;614;392;383;3;0;0;0;380;47110;380;1;47109;387;204;183;"";46722;29766;16956;58
26;"140300";"garwoliński";"mazowieckie";78566;84495;16175;62387;135;1200;427;419;21;0;1;0;397;62785;397;0;62785;619;315;304;"";62166;46680;15486;102
24;"140400";"gostyniński";"mazowieckie";33806;36760;9720;24086;71;549;209;206;2;0;0;0;204;24289;204;0;24289;189;97;92;"";24100;15473;8627;49
21;"140500";"grodziski";"mazowieckie";62149;71872;8206;53949;73;1380;592;577;7;0;4;1;565;54513;565;2;54511;520;297;223;"";53991;24382;29609;51
25;"140600";"grójecki";"mazowieckie";69644;77726;15164;54479;72;1022;462;458;15;1;0;0;442;54918;442;2;54916;447;261;186;"";54469;34668;19801;76
25;"140700";"kozienicki";"mazowieckie";41549;49136;6921;34628;78;828;325;316;7;0;0;1;308;34932;307;0;34932;343;199;144;"";34589;23894;10695;55
21;"140800";"legionowski";"mazowieckie";80783;89422;13127;67649;61;2009;746;721;11;0;1;0;709;68360;709;10;68350;589;323;266;"";67761;29165;38596;63
25;"140900";"lipski";"mazowieckie";25606;28138;7859;17752;33;444;129;125;3;0;0;0;122;17874;122;1;17873;170;82;88;"";17703;12988;4715;42
26;"141000";"łosicki";"mazowieckie";23301;25325;6532;16768;32;511;103;100;2;0;0;0;98;16867;98;0;16867;147;79;68;"";16720;12701;4019;33
23;"141100";"makowski";"mazowieckie";32826;36292;8252;24574;68;797;156;155;1;1;0;0;153;24727;153;0;24727;177;94;83;"";24550;17628;6922;49
26;"141200";"miński";"mazowieckie";108372;118150;22756;85595;45;1723;983;942;35;0;3;0;904;86498;904;4;86494;878;493;385;"";85616;50416;35200;104
22;"141300";"mławski";"mazowieckie";52469;56392;15480;36991;46;616;207;203;9;0;0;1;193;37177;193;0;37177;277;126;151;"";36900;24475;12425;52
21;"141400";"nowodworski";"mazowieckie";56334;61906;13128;43205;67;1016;296;293;2;0;0;0;291;43495;291;5;43490;385;203;182;"";43105;23422;19683;52
23;"141500";"ostrołęcki";"mazowieckie";62536;69547;17389;45147;101;766;253;245;1;0;3;0;241;45386;241;0;45386;370;176;194;"";45016;34307;10709;90
23;"141600";"ostrowski";"mazowieckie";53408;57657;13867;39542;178;896;272;261;5;0;0;0;256;39798;256;1;39797;325;179;146;"";39472;28665;10807;74
21;"141700";"otwocki";"mazowieckie";86266;94501;15680;70588;20;1649;905;877;17;0;0;0;860;71443;860;8;71435;763;432;331;"";70672;38330;32342;86
21;"141800";"piaseczyński";"mazowieckie";122231;137125;17417;104810;83;3180;1403;1344;34;1;10;2;1297;106107;1297;4;106103;958;520;438;"";105145;43509;61636;109
24;"141900";"płocki";"mazowieckie";80531;87621;22952;57579;102;821;429;417;8;0;1;0;408;57983;408;0;57983;522;284;238;"";57461;39086;18375;112
22;"142000";"płoński";"mazowieckie";64660;69867;18999;45661;59;995;333;324;3;0;1;0;320;45977;320;2;45975;371;181;190;"";45604;30222;15382;77
21;"142100";"pruszkowski";"mazowieckie";110303;125343;16207;94096;48;2363;1436;1361;23;3;1;1;1334;95422;1334;8;95414;808;496;312;"";94606;39469;55137;83
22;"142200";"przasnyski";"mazowieckie";37919;40774;11684;26235;55;433;146;143;0;0;0;0;143;26377;143;0;26377;207;116;91;"";26170;18707;7463;61
25;"142300";"przysuski";"mazowieckie";31064;34357;6439;24625;156;695;348;343;14;0;3;0;326;24950;326;1;24949;252;128;124;"";24697;19741;4956;37
23;"142400";"pułtuski";"mazowieckie";37275;41163;9173;28103;57;734;254;249;3;0;0;0;246;28349;246;0;28349;248;112;136;"";28101;18651;9450;51
25;"142500";"radomski";"mazowieckie";107353;118064;25816;81547;112;951;752;732;9;0;2;0;721;82263;721;2;82261;753;388;365;"";81508;60729;20779;114
26;"142600";"siedlecki";"mazowieckie";58180;64144;12757;45421;30;621;372;365;8;0;1;0;356;45778;356;2;45776;397;185;212;"";45379;36187;9192;68
24;"142700";"sierpecki";"mazowieckie";37945;40892;11867;26078;101;460;189;182;9;1;1;0;171;26245;171;0;26245;202;103;99;"";26043;17731;8312;52
24;"142800";"sochaczewski";"mazowieckie";60685;65048;15889;44785;66;693;418;406;1;0;5;2;398;45181;398;1;45180;412;239;173;"";44768;26801;17967;64
26;"142900";"sokołowski";"mazowieckie";40560;43764;9756;30804;86;677;269;266;10;0;1;0;255;31058;255;0;31058;270;149;121;"";30788;22581;8207;49
25;"143000";"szydłowiecki";"mazowieckie";28988;31281;8505;20483;33;278;212;206;3;0;2;1;200;20683;200;1;20682;221;124;97;"";20461;15490;4971;30
21;"143200";"warszawski zachodni";"mazowieckie";79601;89850;12288;67331;32;1827;1024;987;16;2;3;2;964;68275;964;1;68274;612;379;233;"";67662;30478;37184;67
26;"143300";"węgrowski";"mazowieckie";48225;53517;11073;37152;57;1036;325;316;10;0;1;2;303;37452;302;0;37452;322;144;178;"";37130;26280;10850;57
21;"143400";"wołomiński";"mazowieckie";165325;184047;30178;135160;87;3074;1413;1337;33;0;4;0;1306;136407;1307;20;136387;1314;751;563;"";135073;76139;58934;148
23;"143500";"wyszkowski";"mazowieckie";52993;59107;11615;41368;98;1228;269;264;7;0;0;0;257;41625;257;5;41620;376;177;199;"";41244;27968;13276;64
25;"143600";"zwoleński";"mazowieckie";27033;28937;7633;19400;33;317;215;212;1;2;0;0;210;19610;210;2;19608;174;87;87;"";19434;14745;4689;37
22;"143700";"żuromiński";"mazowieckie";28431;30718;8429;20002;50;301;149;145;3;0;1;0;141;20141;141;0;20141;145;81;64;"";19996;13380;6616;29
24;"143800";"żyrardowski";"mazowieckie";53137;57576;12699;40439;28;763;337;331;13;4;1;0;313;40745;313;2;40743;364;202;162;"";40379;22369;18010;62
23;"146100";"Ostrołęka";"mazowieckie";35710;39307;9707;26003;20;347;186;168;2;0;0;0;166;26169;166;3;26166;212;132;80;"";25954;15149;10805;29
24;"146200";"Płock";"mazowieckie";86343;90610;23980;62363;40;814;342;327;4;0;1;0;322;62675;322;10;62665;501;333;168;"";62164;29928;32236;70
25;"146300";"Radom";"mazowieckie";149141;155558;42055;107087;54;1324;1175;1127;20;2;1;1;1103;108182;1103;17;108165;933;588;345;"";107232;59413;47819;114
26;"146400";"Siedlce";"mazowieckie";54765;58158;13762;41003;8;684;389;380;13;0;0;1;366;41367;366;2;41365;366;219;147;"";40999;23778;17221;43
21;"146501";"Warszawa";"mazowieckie";1289880;1340188;267625;1022297;568;34233;16296;15559;263;38;42;17;15206;1037355;15204;101;1037254;9141;5638;3503;"";1028113;332554;695559;771
21;"149800";"statki";"mazowieckie";425;384;42;383;0;78;0;0;0;0;0;0;0;383;0;0;383;23;14;9;"";360;110;250;8
21;"149900";"zagranica";"mazowieckie";83965;525355;18926;35131;0;4749;480262;399360;14531;269;420;247;383948;418853;383723;816;418037;2086;1243;843;"";415951;107647;308304;169
27;"160100";"brzeski";"opolskie";63957;68554;20909;43046;36;562;415;398;10;0;4;1;383;43429;381;4;43425;361;178;183;"";43064;22912;20152;77
27;"160200";"głubczycki";"opolskie";33127;36059;11142;21985;39;376;244;237;3;1;0;0;233;22217;233;1;22216;184;93;91;"";22032;13257;8775;54
27;"160300";"kędzierzyńsko-kozielski";"opolskie";67131;71044;26394;40758;24;488;431;399;6;0;0;0;393;41142;393;6;41136;386;222;164;"";40750;17183;23567;62
27;"160400";"kluczborski";"opolskie";47081;50942;17500;29631;63;470;299;289;3;0;3;0;283;29912;283;0;29912;242;142;100;"";29670;14855;14815;63
27;"160500";"krapkowicki";"opolskie";45640;49334;19638;26002;30;356;343;333;15;0;4;1;313;26316;313;2;26314;216;110;106;"";26098;10977;15121;51
27;"160600";"namysłowski";"opolskie";31163;33573;9684;21480;11;306;154;147;1;0;3;0;143;21621;143;3;21618;164;85;79;"";21454;11484;9970;56
27;"160700";"nyski";"opolskie";95436;108249;30115;65322;79;1248;842;807;14;4;2;0;787;66101;787;1;66100;445;221;224;"";65655;36466;29189;120
27;"160800";"oleski";"opolskie";45632;51326;16808;28834;37;456;343;339;7;0;2;0;330;29157;330;0;29157;307;166;141;"";28850;15321;13529;55
27;"160900";"opolski";"opolskie";89873;97598;35741;54131;55;904;484;476;8;0;5;1;464;54595;464;3;54592;455;249;206;"";54137;22705;31432;113
27;"161000";"prudnicki";"opolskie";40012;42883;15429;24582;21;311;271;266;6;0;1;0;259;24842;259;1;24841;202;119;83;"";24639;13751;10888;69
27;"161100";"strzelecki";"opolskie";54953;59536;23052;31900;18;403;331;324;11;1;1;0;311;32212;311;0;32212;283;140;143;"";31929;15278;16651;72
27;"166100";"Opole";"opolskie";90978;97348;23970;67001;45;1227;758;719;17;0;0;1;702;67702;702;4;67698;646;375;271;"";67052;21459;45593;79
29;"180100";"bieszczadzki";"podkarpackie";17037;19366;5070;11967;18;1765;123;122;3;0;0;0;119;12086;119;1;12085;114;61;53;"";11971;6595;5376;30
29;"180200";"brzozowski";"podkarpackie";48090;52032;13737;34352;124;507;312;302;4;1;0;0;297;34647;297;0;34647;227;139;88;"";34420;28308;6112;59
28;"180300";"dębicki";"podkarpackie";97138;105318;25673;71465;91;760;844;827;13;2;3;0;809;72272;809;1;72271;623;371;252;"";71648;53676;17972;109
30;"180400";"jarosławski";"podkarpackie";87345;95099;27260;60056;108;760;1264;1231;28;0;14;3;1186;61238;1186;10;61228;464;228;236;"";60764;46023;14741;113
29;"180500";"jasielski";"podkarpackie";84377;90812;24187;60191;88;953;704;691;20;1;0;1;669;60861;669;0;60861;508;281;227;"";60353;45906;14447;121
31;"180600";"kolbuszowski";"podkarpackie";45575;48945;14747;30825;51;303;375;367;2;2;0;0;363;31187;363;0;31187;298;156;142;"";30889;24835;6054;64
29;"180700";"krośnieński";"podkarpackie";82774;90123;23106;59688;105;1716;715;705;11;4;0;3;687;60374;687;0;60374;496;273;223;"";59878;44376;15502;106
28;"180800";"leżajski";"podkarpackie";50803;54297;15577;35226;78;445;392;389;6;0;3;0;380;35605;380;5;35600;305;177;128;"";35295;28578;6717;54
30;"180900";"lubaczowski";"podkarpackie";41251;44618;13811;27439;47;738;276;265;8;0;2;0;255;27694;255;1;27693;233;131;102;"";27460;20328;7132;60
28;"181000";"łańcucki";"podkarpackie";57854;63184;13626;44221;27;505;619;602;10;0;2;0;590;44808;589;0;44808;441;221;220;"";44367;33945;10422;55
31;"181100";"mielecki";"podkarpackie";99011;105357;29119;69892;67;672;912;884;19;0;3;1;861;70754;862;2;70752;623;370;253;"";70129;50014;20115;117
31;"181200";"niżański";"podkarpackie";49809;52768;17680;32129;38;438;377;368;8;0;0;1;359;32487;359;4;32483;298;154;144;"";32185;24878;7307;71
30;"181300";"przemyski";"podkarpackie";53195;58832;16459;36737;51;786;505;469;7;0;2;0;460;37195;460;2;37193;302;167;135;"";36891;28048;8843;95
30;"181400";"przeworski";"podkarpackie";55955;62558;15254;40701;117;413;603;580;12;2;0;0;566;41264;565;0;41264;324;179;145;"";40940;31746;9194;72
28;"181500";"ropczycko-sędziszowski";"podkarpackie";53730;57981;13593;40137;81;369;357;349;11;0;0;0;338;40473;338;2;40471;352;197;155;"";40119;32515;7604;69
28;"181600";"rzeszowski";"podkarpackie";121025;131912;28802;92222;112;930;1025;992;22;0;10;0;960;93171;960;1;93170;883;482;401;"";92287;69996;22291;126
29;"181700";"sanocki";"podkarpackie";69579;74457;23182;46398;79;1255;378;363;7;0;0;0;356;46747;356;2;46745;384;240;144;"";46361;30759;15602;72
31;"181800";"stalowowolski";"podkarpackie";78060;81818;27088;50971;61;707;586;568;21;1;1;1;544;51514;544;0;51514;462;243;219;"";51052;34576;16476;82
28;"181900";"strzyżowski";"podkarpackie";45436;48944;13452;31984;29;504;401;398;15;1;3;0;379;32363;379;0;32363;276;153;123;"";32087;25182;6905;64
31;"182000";"tarnobrzeski";"podkarpackie";38515;42463;11673;26842;47;348;262;253;10;0;2;0;241;27082;241;0;27082;235;136;99;"";26847;19702;7145;49
29;"182100";"leski";"podkarpackie";26723;29311;6049;20674;34;5943;158;156;6;0;0;0;150;20824;150;0;20824;153;87;66;"";20671;11616;9055;31
29;"186100";"Krosno";"podkarpackie";34167;36331;9950;24217;33;499;299;288;5;0;0;0;283;24497;283;3;24494;210;129;81;"";24284;13354;10930;28
30;"186200";"Przemyśl";"podkarpackie";44651;47264;15710;28941;39;611;458;442;17;2;1;2;420;29356;420;0;29356;258;155;103;"";29098;16051;13047;39
28;"186300";"Rzeszów";"podkarpackie";136661;150771;32482;104178;63;1895;1396;1353;67;0;2;2;1282;105449;1282;3;105446;1047;631;416;"";104399;52529;51870;98
31;"186400";"Tarnobrzeg";"podkarpackie";34782;36284;11427;23354;16;351;263;255;8;0;0;0;247;23600;247;1;23599;216;136;80;"";23383;12109;11274;34
34;"200100";"augustowski";"podlaskie";43560;48662;12774;30784;64;2922;225;218;1;2;1;0;214;30994;214;6;30988;292;149;143;"";30696;18383;12313;44
32;"200200";"białostocki";"podlaskie";108489;117445;31031;77455;88;1608;960;930;19;1;3;0;907;78364;907;2;78362;834;466;368;"";77528;47121;30407;123
32;"200300";"bielski";"podlaskie";41424;44160;13840;27583;123;526;226;219;4;0;1;0;214;27793;214;0;27793;205;112;93;"";27588;16604;10984;50
33;"200400";"grajewski";"podlaskie";34590;37290;12466;22124;27;722;188;181;3;1;0;0;178;22301;178;0;22301;194;103;91;"";22107;15244;6863;43
32;"200500";"hajnowski";"podlaskie";32930;37108;11568;21360;31;1442;111;101;0;0;0;0;101;21462;101;0;21462;159;78;81;"";21303;8284;13019;47
33;"200600";"kolneński";"podlaskie";28326;30426;10282;18044;12;326;155;151;1;0;0;0;150;18194;150;0;18194;165;87;78;"";18029;14074;3955;41
33;"200700";"łomżyński";"podlaskie";37033;40663;11322;25711;70;455;193;191;8;0;0;0;183;25892;183;0;25892;247;109;138;"";25645;20249;5396;53
32;"200800";"moniecki";"podlaskie";30069;32446;11649;18420;50;471;190;187;10;0;0;0;177;18597;177;0;18597;146;83;63;"";18451;13328;5123;33
34;"200900";"sejneński";"podlaskie";15412;17682;4805;10606;32;1293;139;137;8;0;0;0;129;10734;129;1;10733;88;49;39;"";10645;5461;5184;21
32;"201000";"siemiatycki";"podlaskie";34228;36527;12559;21669;84;838;114;108;6;0;2;0;100;21769;100;0;21769;170;87;83;"";21599;13511;8088;48
34;"201100";"sokólski";"podlaskie";50071;53734;18663;31408;70;548;316;310;8;3;0;0;299;31707;299;0;31707;276;137;139;"";31431;21302;10129;63
34;"201200";"suwalski";"podlaskie";26326;29983;7310;19014;94;1462;76;74;1;0;0;0;73;19088;73;1;19087;160;96;64;"";18927;12301;6626;38
33;"201300";"wysokomazowiecki";"podlaskie";42608;45332;11338;31270;67;574;290;285;2;0;0;0;283;31552;283;0;31552;355;208;147;"";31197;25250;5947;60
33;"201400";"zambrowski";"podlaskie";32479;34447;10450;22029;47;262;141;140;0;0;0;0;140;22169;140;0;22169;217;102;115;"";21952;15928;6024;45
32;"206100";"Białystok";"podlaskie";202391;215787;55481;146909;81;2443;1682;1606;29;6;4;2;1565;148467;1565;6;148461;1523;948;575;"";146938;70236;76702;185
33;"206200";"Łomża";"podlaskie";44070;45757;15177;28893;13;422;362;333;7;0;2;0;324;29217;324;0;29217;229;146;83;"";28988;17598;11390;32
34;"206300";"Suwałki";"podlaskie";49506;52316;16369;33137;46;842;244;230;5;0;3;0;222;33357;222;2;33355;269;168;101;"";33086;17615;15471;38
36;"220100";"bytowski";"pomorskie";50238;61080;11702;38536;37;1716;207;201;3;2;6;0;190;38723;190;2;38721;320;175;145;"";38401;19375;19026;66
36;"220200";"chojnicki";"pomorskie";65610;74632;15838;49770;39;2167;438;424;5;1;5;0;413;50184;413;5;50179;406;231;175;"";49773;26414;23359;68
36;"220300";"człuchowski";"pomorskie";39450;44221;13036;26414;27;891;129;126;0;0;0;0;126;26539;126;4;26535;213;125;88;"";26322;11856;14466;57
35;"220400";"gdański";"pomorskie";78538;86591;18848;59713;31;1403;403;385;3;0;14;0;368;60082;368;3;60079;540;322;218;"";59539;21406;38133;59
36;"220500";"kartuski";"pomorskie";89777;103386;14501;75273;32;3032;463;443;16;1;1;0;429;75680;429;3;75677;697;391;306;"";74980;39913;35067;75
36;"220600";"kościerski";"pomorskie";51213;57367;11045;40168;37;2614;369;360;11;1;0;2;346;40510;346;2;40508;324;184;140;"";40184;21289;18895;48
35;"220700";"kwidzyński";"pomorskie";57953;61247;21006;36947;37;589;227;206;5;1;0;0;200;37143;200;11;37132;342;195;147;"";36790;17843;18947;67
36;"220800";"lęborski";"pomorskie";47733;54162;10811;36922;23;5006;204;196;10;0;0;0;186;37100;186;0;37100;298;188;110;"";36802;15369;21433;46
35;"220900";"malborski";"pomorskie";44919;47652;15459;29461;57;550;259;248;9;0;0;0;239;29687;239;2;29685;209;119;90;"";29476;12020;17456;37
35;"221000";"nowodworski";"pomorskie";33261;36914;7587;25675;7;7208;124;120;4;0;0;0;116;25790;116;0;25790;186;102;84;"";25604;10034;15570;30
36;"221100";"pucki";"pomorskie";90114;100635;11631;78611;24;25631;328;302;3;0;0;1;299;78883;299;9;78874;577;332;245;"";78297;29403;48894;53
36;"221200";"słupski";"pomorskie";68351;81725;15721;52630;70;7791;272;267;10;1;4;0;252;52872;252;4;52868;388;198;190;"";52480;22216;30264;88
35;"221300";"starogardzki";"pomorskie";89018;96616;26983;62053;65;1518;471;456;2;0;2;0;452;62502;452;4;62498;499;266;233;"";61999;34526;27473;94
35;"221400";"tczewski";"pomorskie";77866;84713;24046;53828;47;583;436;414;17;2;0;1;394;54216;394;1;54215;484;293;191;"";53731;26203;27528;75
36;"221500";"wejherowski";"pomorskie";143171;161535;29976;113225;57;4631;864;831;16;1;2;4;808;114035;808;12;114023;1111;671;440;"";112912;49316;63596;105
35;"221600";"sztumski";"pomorskie";30429;32412;12119;18304;21;244;124;122;1;0;0;0;121;18424;121;3;18421;161;84;77;"";18260;8821;9439;41
35;"226100";"Gdańsk";"pomorskie";327297;368850;53567;273809;94;11894;2841;2677;49;3;5;2;2620;276417;2620;22;276395;2309;1473;836;"";274086;81737;192349;199
36;"226200";"Gdynia";"pomorskie";172966;186515;34470;138513;82;4605;1639;1561;34;3;2;1;1521;139979;1522;9;139970;1237;731;506;"";138733;41539;97194;118
36;"226300";"Słupsk";"pomorskie";64553;67154;20040;44529;9;911;420;413;6;0;1;0;406;44908;406;8;44900;350;212;138;"";44550;16855;27695;47
35;"226400";"Sopot";"pomorskie";27688;31657;3525;24181;36;3183;412;385;6;0;1;0;378;24566;378;2;24564;204;107;97;"";24360;6781;17579;24
37;"240100";"będziński";"śląskie";107942;115047;30578;77364;77;1238;856;836;23;0;3;0;810;78175;810;2;78173;655;396;259;"";77518;32294;45224;99
38;"240200";"bielski";"śląskie";116583;127404;25600;90982;86;2142;1459;1409;30;1;8;4;1368;92329;1368;5;92324;935;549;386;"";91389;46897;44492;93
38;"240300";"cieszyński";"śląskie";129127;141286;34095;95067;70;4199;2281;2222;66;2;23;5;2126;97182;2126;8;97174;869;525;344;"";96305;45887;50418;124
39;"240400";"częstochowski";"śląskie";98207;108793;24716;73489;77;1175;611;591;13;0;5;0;573;74053;573;0;74053;717;387;330;"";73336;43021;30315;120
37;"240500";"gliwicki";"śląskie";80864;87031;26508;54352;38;693;718;696;25;0;3;1;667;55018;665;4;55014;562;319;243;"";54452;27798;26654;76
39;"240600";"kłobucki";"śląskie";62157;68230;16804;45356;70;775;435;423;7;0;6;0;410;45766;410;0;45766;431;266;165;"";45335;26190;19145;64
39;"240700";"lubliniecki";"śląskie";55274;60891;18010;37263;35;566;569;558;17;0;0;0;541;37802;541;1;37801;347;198;149;"";37454;20960;16494;60
38;"240800";"mikołowski";"śląskie";67826;73601;17096;50730;58;728;1185;1133;27;2;18;0;1087;51817;1087;5;51812;529;320;209;"";51283;25024;26259;63
39;"240900";"myszkowski";"śląskie";50710;56820;13068;37641;56;808;464;449;22;0;1;0;426;38065;425;3;38062;343;202;141;"";37719;21564;16155;56
38;"241000";"pszczyński";"śląskie";77022;82912;18497;58519;13;678;1258;1222;11;0;9;0;1202;59722;1202;9;59713;582;356;226;"";59131;35489;23642;74
38;"241100";"raciborski";"śląskie";75529;82145;28930;46598;21;548;770;719;38;5;0;0;676;47272;676;1;47271;412;224;188;"";46859;23536;23323;68
38;"241200";"rybnicki";"śląskie";54112;58973;15352;38760;24;360;884;859;23;2;12;2;820;39577;819;0;39577;340;194;146;"";39237;23937;15300;48
37;"241300";"tarnogórski";"śląskie";100678;107912;30008;70672;47;1088;1180;1154;19;0;12;1;1122;71791;1122;0;71791;661;383;278;"";71130;34338;36792;85
37;"241400";"bieruńsko-lędziński";"śląskie";41717;45430;10770;30944;36;348;511;497;4;1;1;2;489;31435;489;2;31433;312;174;138;"";31121;19414;11707;41
38;"241500";"wodzisławski";"śląskie";105879;118728;31931;73947;45;845;4894;4702;68;20;17;1;4596;78534;4596;10;78524;675;389;286;"";77849;46000;31849;100
37;"241600";"zawierciański";"śląskie";88022;95278;23857;64164;77;1318;646;638;9;0;2;0;627;64789;627;2;64787;504;316;188;"";64283;35614;28669;108
38;"241700";"żywiecki";"śląskie";105542;122004;20781;84808;134;3307;1457;1418;16;0;3;4;1396;86190;1394;21;86169;900;515;385;"";85269;54249;31020;106
38;"246100";"Bielsko-Biała";"śląskie";105180;128592;15054;90169;72;1735;1286;1234;21;3;15;2;1193;91337;1194;10;91327;842;539;303;"";90485;39670;50815;76
37;"246200";"Bytom";"śląskie";109339;114972;40561;68781;40;785;689;636;12;1;1;3;620;69395;620;9;69386;672;388;284;"";68714;31525;37189;81
37;"246300";"Chorzów";"śląskie";73448;77119;25502;47944;35;631;620;569;11;1;5;5;547;48487;546;0;48487;445;227;218;"";48042;19103;28939;63
39;"246400";"Częstochowa";"śląskie";157376;168613;41634;115746;69;1817;1198;1166;17;1;4;0;1144;116860;1145;8;116852;965;596;369;"";115887;51415;64472;135
37;"246500";"Dąbrowa Górnicza";"śląskie";85168;90460;24048;61102;24;835;505;488;21;6;3;3;455;61549;455;2;61547;476;299;177;"";61071;25251;35820;67
37;"246600";"Gliwice";"śląskie";124973;131136;36213;88718;70;1546;1086;1007;12;4;3;2;987;89694;985;5;89689;842;475;367;"";88847;34512;54335;116
38;"246700";"Jastrzębie-Zdrój";"śląskie";62822;66078;20628;42195;28;491;1196;1121;20;0;10;1;1090;43285;1090;2;43283;352;191;161;"";42931;26031;16900;38
37;"246800";"Jaworzno";"śląskie";65227;69220;19935;45292;47;569;523;496;14;1;4;1;476;45766;475;0;45766;378;210;168;"";45388;21273;24115;48
37;"246900";"Katowice";"śląskie";205780;219590;55486;150282;94;2749;1918;1818;22;6;14;1;1775;152048;1775;12;152036;1338;797;541;"";150698;57971;92727;169
37;"247000";"Mysłowice";"śląskie";51417;54459;15112;36304;15;469;372;342;6;3;3;0;330;36633;330;4;36629;329;207;122;"";36300;18013;18287;40
37;"247100";"Piekary Śląskie";"śląskie";38834;41462;11917;26916;38;282;271;269;1;0;3;0;265;27181;265;2;27179;254;157;97;"";26925;14163;12762;32
37;"247200";"Ruda Śląska";"śląskie";95222;101814;30874;64348;47;677;604;573;20;0;1;1;551;64897;551;2;64895;604;337;267;"";64291;32879;31412;79
38;"247300";"Rybnik";"śląskie";96544;102295;29260;67286;10;737;1163;1102;29;1;3;2;1068;68354;1068;2;68352;593;343;250;"";67759;35092;32667;70
37;"247400";"Siemianowice Śląskie";"śląskie";46578;48856;14692;31886;19;487;343;326;13;1;1;2;309;32191;309;0;32191;310;175;135;"";31881;13192;18689;41
37;"247500";"Sosnowiec";"śląskie";144296;152089;43756;100540;84;1234;761;719;11;0;5;0;703;101232;702;12;101220;765;476;289;"";100455;41023;59432;107
37;"247600";"Świętochłowice";"śląskie";33348;36003;12027;21321;5;219;203;185;2;0;1;1;181;21501;180;0;21501;199;114;85;"";21302;9969;11333;27
37;"247700";"Tychy";"śląskie";89059;93694;24003;65060;41;998;905;872;29;0;3;0;840;65901;839;9;65892;661;390;271;"";65231;29777;35454;66
37;"247800";"Zabrze";"śląskie";117456;123491;47457;69999;59;925;604;571;12;2;6;0;551;70547;551;0;70547;671;384;287;"";69876;31315;38561;90
38;"247900";"Żory";"śląskie";42339;45350;12178;30161;10;358;568;550;11;0;22;4;513;30673;513;2;30671;297;180;117;"";30374;15847;14527;23
40;"260100";"buski";"świętokrzyskie";55534;59874;16879;38655;122;1110;291;283;4;1;0;0;278;38933;278;2;38931;241;141;100;"";38690;26350;12340;64
40;"260200";"jędrzejowski";"świętokrzyskie";63600;69417;17577;46023;110;950;391;387;5;0;0;0;382;46404;382;0;46404;320;178;142;"";46084;33354;12730;75
40;"260300";"kazimierski";"świętokrzyskie";25618;27848;9320;16298;33;214;189;180;7;0;0;0;173;16471;173;1;16470;100;46;54;"";16370;11808;4562;31
40;"260400";"kielecki";"świętokrzyskie";154544;168224;39061;115483;199;1808;897;869;7;0;6;1;855;116334;855;1;116333;1096;635;461;"";115237;82043;33194;184
40;"260500";"konecki";"świętokrzyskie";60652;65935;16703;43949;96;1114;358;350;10;0;2;0;338;44286;338;0;44286;384;216;168;"";43902;29903;13999;75
40;"260600";"opatowski";"świętokrzyskie";37783;42681;11232;26551;51;470;254;245;0;1;0;0;244;26795;244;0;26795;250;147;103;"";26545;19676;6869;56
40;"260700";"ostrowiecki";"świętokrzyskie";81752;85436;29264;52474;97;749;562;549;10;0;0;0;539;53011;539;4;53007;443;249;194;"";52564;30807;21757;78
40;"260800";"pińczowski";"świętokrzyskie";30421;33373;9570;20851;38;446;176;172;1;0;4;0;167;21017;167;0;21017;147;73;74;"";20870;14368;6502;35
40;"260900";"sandomierski";"świętokrzyskie";57469;63074;17629;39840;147;857;286;280;3;0;1;0;276;40105;276;0;40105;336;197;139;"";39769;25624;14145;62
40;"261000";"skarżyski";"świętokrzyskie";56303;59094;17738;38565;99;628;395;376;12;1;3;0;360;38924;360;1;38923;338;200;138;"";38585;21772;16813;60
40;"261100";"starachowicki";"świętokrzyskie";66440;70510;20954;45486;59;690;728;705;11;0;5;0;689;46172;689;3;46169;391;206;185;"";45778;28248;17530;65
40;"261200";"staszowski";"świętokrzyskie";53255;58610;15322;37933;84;605;273;270;4;0;2;0;264;38197;264;1;38196;292;154;138;"";37904;27822;10082;70
40;"261300";"włoszczowski";"świętokrzyskie";32906;36916;8091;24815;67;556;155;151;17;0;1;0;133;24948;133;0;24948;214;108;106;"";24734;17987;6747;39
40;"266100";"Kielce";"świętokrzyskie";141175;148221;37098;104078;40;1495;989;919;12;0;9;1;897;104961;897;3;104958;875;555;320;"";104083;49605;54478;95
42;"280100";"bartoszycki";"warmińsko-mazurskie";41187;45659;15403;25784;64;582;82;76;11;0;0;0;65;25851;65;0;25851;185;102;83;"";25666;12815;12851;44
42;"280200";"braniewski";"warmińsko-mazurskie";28597;32703;10409;18188;40;422;118;116;0;0;0;0;117;18305;117;1;18304;150;79;71;"";18154;8855;9299;37
42;"280300";"działdowski";"warmińsko-mazurskie";48706;51118;17559;31147;59;795;91;88;1;0;4;0;83;31230;83;2;31228;209;107;102;"";31019;18251;12768;55
42;"280400";"elbląski";"warmińsko-mazurskie";38965;44260;13781;25185;23;530;173;164;8;0;0;0;156;25341;156;0;25341;192;88;104;"";25149;12630;12519;43
41;"280500";"ełcki";"warmińsko-mazurskie";62184;68316;23766;38417;29;1739;349;325;1;1;0;0;323;38733;323;7;38726;384;211;173;"";38342;19230;19112;53
41;"280600";"giżycki";"warmińsko-mazurskie";42160;51250;8124;34036;28;6317;204;195;9;0;9;0;177;34206;177;0;34206;271;151;120;"";33935;13164;20771;48
42;"280700";"iławski";"warmińsko-mazurskie";65634;72749;20126;45508;28;1725;324;316;3;3;1;0;309;45813;309;1;45812;334;175;159;"";45478;24284;21194;65
41;"280800";"kętrzyński";"warmińsko-mazurskie";45759;48984;18005;27754;25;895;220;207;4;0;2;0;201;27955;201;0;27955;192;86;106;"";27763;13297;14466;58
42;"280900";"lidzbarski";"warmińsko-mazurskie";27518;32068;8951;18567;18;437;114;108;6;0;1;0;101;18668;101;1;18667;138;58;80;"";18529;8746;9783;34
41;"281000";"mrągowski";"warmińsko-mazurskie";37657;44514;8906;28739;31;4737;124;114;2;0;1;0;111;28846;111;0;28846;220;122;98;"";28626;12301;16325;43
41;"281100";"nidzicki";"warmińsko-mazurskie";23421;25712;7968;15453;12;599;132;131;4;0;1;0;126;15579;126;9;15570;157;86;71;"";15413;8947;6466;30
42;"281200";"nowomiejski";"warmińsko-mazurskie";29472;33813;8437;21045;17;481;107;102;4;0;0;0;98;21141;98;1;21140;173;80;93;"";20967;13289;7678;33
41;"281300";"olecki";"warmińsko-mazurskie";24279;26310;9499;14780;13;750;102;97;3;0;0;0;94;14872;94;0;14872;125;48;77;"";14747;8099;6648;33
41;"281400";"olsztyński";"warmińsko-mazurskie";90206;102598;25910;64291;36;3850;389;373;16;0;0;0;358;64648;358;3;64645;596;320;276;"";64049;26776;37273;133
42;"281500";"ostródzki";"warmińsko-mazurskie";69198;82783;18709;50488;46;2845;286;276;7;0;0;0;269;50757;269;9;50748;381;202;179;"";50367;22612;27755;81
41;"281600";"piski";"warmińsko-mazurskie";42771;48736;13253;29517;59;4456;112;105;5;0;0;0;100;29617;100;2;29615;242;127;115;"";29373;15861;13512;44
41;"281700";"szczycieński";"warmińsko-mazurskie";52128;59223;15107;37022;46;3697;227;223;2;1;0;0;220;37237;220;1;37236;320;169;151;"";36916;19242;17674;68
41;"281800";"gołdapski";"warmińsko-mazurskie";19075;20901;7337;11738;18;763;92;91;0;0;0;0;91;11829;91;0;11829;78;42;36;"";11751;5522;6229;24
41;"281900";"węgorzewski";"warmińsko-mazurskie";17257;19728;4948;12309;17;1787;47;45;2;0;1;0;42;12351;42;0;12351;108;50;58;"";12243;5222;7021;26
42;"286100";"Elbląg";"warmińsko-mazurskie";80187;87762;23642;56545;39;900;392;384;3;1;2;0;378;56918;378;5;56913;500;275;225;"";56413;24050;32363;62
41;"286200";"Olsztyn";"warmińsko-mazurskie";119800;129254;29102;90694;61;2359;711;672;10;3;0;2;658;91346;657;0;91346;787;510;277;"";90559;32530;58029;101
47;"300100";"chodzieski";"wielkopolskie";34020;36237;9672;24348;41;409;125;117;3;0;0;0;114;24462;114;0;24462;213;125;88;"";24249;9534;14715;36
47;"300200";"czarnkowsko-trzcianecki";"wielkopolskie";62180;66619;18876;43304;39;854;340;329;3;0;0;0;326;43627;326;0;43627;340;185;155;"";43287;19536;23751;61
45;"300300";"gnieźnieński";"wielkopolskie";103662;111104;28918;74745;63;1255;608;594;10;5;2;0;577;75318;577;5;75313;602;358;244;"";74711;35281;39430;92
46;"300400";"gostyński";"wielkopolskie";54233;58630;17606;36678;17;363;505;495;8;0;4;1;482;37159;482;2;37157;346;199;147;"";36811;21447;15364;58
43;"300500";"grodziski";"wielkopolskie";36463;39133;10839;25625;20;299;220;214;3;2;0;0;209;25834;210;0;25834;253;138;115;"";25581;13447;12134;30
44;"300600";"jarociński";"wielkopolskie";51055;54736;15252;35803;18;414;334;331;6;2;1;0;322;36125;322;1;36124;312;177;135;"";35812;20240;15572;37
44;"300700";"kaliski";"wielkopolskie";59914;65605;16111;43802;56;447;499;487;17;0;9;0;461;44264;461;0;44264;434;258;176;"";43830;29489;14341;62
44;"300800";"kępiński";"wielkopolskie";34549;43493;9869;24679;28;497;4642;4499;152;1;6;3;4337;29018;4337;0;29018;209;115;94;"";28809;15222;13587;43
45;"300900";"kolski";"wielkopolskie";63623;67938;19534;44089;48;620;341;333;12;1;1;0;319;44406;319;2;44404;359;192;167;"";44045;29921;14124;62
45;"301000";"koniński";"wielkopolskie";93801;102839;25174;68624;110;1732;548;526;14;0;3;0;509;69131;509;1;69130;620;383;237;"";68510;46776;21734;96
46;"301100";"kościański";"wielkopolskie";57240;61284;16363;40877;13;510;368;363;7;2;2;0;355;41230;355;2;41228;362;206;156;"";40866;20086;20780;53
44;"301200";"krotoszyński";"wielkopolskie";54522;59050;16563;37959;41;454;434;418;8;0;0;0;410;38366;410;1;38365;328;196;132;"";38037;21501;16536;45
46;"301300";"leszczyński";"wielkopolskie";40408;44542;10629;29779;9;995;213;205;6;1;0;1;197;29976;197;0;29976;256;141;115;"";29720;14325;15395;39
43;"301400";"międzychodzki";"wielkopolskie";26244;29065;7429;18815;13;674;127;123;6;0;0;0;117;18932;117;0;18932;138;69;69;"";18794;7720;11074;22
43;"301500";"nowotomyski";"wielkopolskie";52173;57387;13020;39153;22;619;219;214;0;0;2;0;212;39362;212;3;39359;328;210;118;"";39031;16737;22294;49
43;"301600";"obornicki";"wielkopolskie";40896;44606;11045;29852;6;453;227;225;4;0;0;0;221;30072;221;2;30070;246;135;111;"";29824;12543;17281;46
44;"301700";"ostrowski";"wielkopolskie";116422;124958;32260;84162;85;934;679;651;12;0;1;0;638;84793;638;6;84787;667;406;261;"";84120;43455;40665;110
44;"301800";"ostrzeszowski";"wielkopolskie";39401;43444;11089;28313;17;479;619;607;35;1;0;3;568;28879;568;7;28872;241;132;109;"";28631;15789;12842;55
47;"301900";"pilski";"wielkopolskie";95310;102006;28008;67301;68;1327;525;502;8;2;3;0;489;67786;489;3;67783;600;356;244;"";67183;29249;37934;82
44;"302000";"pleszewski";"wielkopolskie";45184;48722;13006;32177;44;386;358;352;9;0;0;0;343;32519;343;2;32517;281;177;104;"";32236;18506;13730;54
43;"302100";"poznański";"wielkopolskie";271479;296370;47096;224369;130;4903;2476;2366;42;2;7;2;2313;226666;2313;16;226650;1963;1219;744;"";224687;73009;151678;206
46;"302200";"rawicki";"wielkopolskie";43484;46565;14069;29415;23;328;280;262;16;0;6;0;240;29652;240;1;29651;257;146;111;"";29394;15078;14316;43
45;"302300";"słupecki";"wielkopolskie";44074;47761;12922;31153;41;1083;186;175;3;0;0;0;172;31327;172;3;31324;221;124;97;"";31103;18236;12867;42
43;"302400";"szamotulski";"wielkopolskie";65479;71074;16966;48514;76;789;346;341;5;2;2;0;332;48839;332;3;48836;430;258;172;"";48406;20009;28397;55
45;"302500";"średzki";"wielkopolskie";41954;45068;11631;30323;6;316;222;216;3;0;0;0;213;30530;213;0;30530;305;168;137;"";30225;14969;15256;39
45;"302600";"śremski";"wielkopolskie";43029;46781;12010;31018;14;442;212;206;7;0;1;0;198;31212;198;1;31211;306;204;102;"";30905;14786;16119;36
45;"302700";"turecki";"wielkopolskie";60950;65773;17719;43229;46;463;467;444;11;2;0;1;430;43660;430;1;43659;376;226;150;"";43283;28868;14415;58
47;"302800";"wągrowiecki";"wielkopolskie";49482;53313;14839;34643;24;620;227;219;1;0;2;0;216;34859;216;0;34859;282;163;119;"";34577;16326;18251;47
43;"302900";"wolsztyński";"wielkopolskie";40181;44306;9258;30923;22;1013;126;123;13;0;0;0;110;31032;110;0;31032;357;209;148;"";30675;14675;16000;41
45;"303000";"wrzesiński";"wielkopolskie";54782;59459;14397;40386;28;475;312;297;4;0;0;0;293;40677;292;4;40673;315;191;124;"";40358;20589;19769;52
47;"303100";"złotowski";"wielkopolskie";49984;53195;17991;31992;25;649;224;216;4;0;0;2;210;32201;210;4;32197;257;144;113;"";31940;14746;17194;48
44;"306100";"Kalisz";"wielkopolskie";71738;74433;20202;51533;30;797;392;382;5;0;0;0;377;51904;377;3;51901;399;249;150;"";51502;21119;30383;55
45;"306200";"Konin";"wielkopolskie";54410;57280;15407;39002;6;554;279;276;0;1;0;1;274;39279;274;1;39278;292;169;123;"";38986;18860;20126;47
46;"306300";"Leszno";"wielkopolskie";45486;46988;12414;33072;29;483;296;291;4;0;0;0;287;33354;286;8;33346;312;176;136;"";33034;11226;21808;34
43;"306400";"Poznań";"wielkopolskie";377058;411294;70489;306625;147;7971;4013;3771;57;23;12;4;3677;310279;3678;29;310250;2694;1627;1067;"";307556;86290;221266;251
49;"320100";"białogardzki";"zachodniopomorskie";33711;35833;12707;21004;17;287;194;190;1;4;0;0;185;21190;185;1;21189;176;101;75;"";21013;9503;11510;35
49;"320200";"choszczeński";"zachodniopomorskie";32531;37447;10551;21972;35;581;120;111;7;1;0;0;103;22075;103;0;22075;166;91;75;"";21909;10747;11162;37
49;"320300";"drawski";"zachodniopomorskie";42070;45419;14774;27295;40;1463;142;135;5;0;0;3;127;27421;127;0;27421;201;92;109;"";27220;12174;15046;51
48;"320400";"goleniowski";"zachodniopomorskie";59085;64509;19031;40054;29;652;271;261;6;0;1;0;254;40303;254;1;40302;367;210;157;"";39935;17601;22334;51
48;"320500";"gryficki";"zachodniopomorskie";55171;59476;15154;40016;43;10102;270;264;2;0;1;1;260;40270;260;1;40269;263;127;136;"";40006;16715;23291;45
48;"320600";"gryfiński";"zachodniopomorskie";57969;62701;19118;38860;39;691;300;285;13;0;0;1;271;39130;271;3;39127;351;206;145;"";38776;19046;19730;62
48;"320700";"kamieński";"zachodniopomorskie";43644;48668;9688;33954;16;9488;203;196;4;0;0;0;192;34146;192;1;34145;190;105;85;"";33955;13147;20808;43
49;"320800";"kołobrzeski";"zachodniopomorskie";72448;78463;16126;56323;45;14631;307;295;5;0;5;0;285;56595;285;14;56581;374;190;184;"";56207;21819;34388;53
49;"320900";"koszaliński";"zachodniopomorskie";57376;63762;13773;43602;40;10006;206;199;3;0;0;0;196;43795;196;1;43794;326;184;142;"";43468;17722;25746;62
48;"321000";"myśliborski";"zachodniopomorskie";46548;50165;16146;30402;33;576;199;188;1;0;1;0;186;30588;186;1;30587;206;97;109;"";30381;13750;16631;53
48;"321100";"policki";"zachodniopomorskie";53668;58100;13002;40666;31;1009;406;392;3;1;2;1;387;41050;387;6;41044;350;215;135;"";40694;14194;26500;43
48;"321200";"pyrzycki";"zachodniopomorskie";28127;30372;9772;18355;23;238;144;143;0;2;0;0;141;18497;142;4;18493;155;78;77;"";18338;10568;7770;27
49;"321300";"sławieński";"zachodniopomorskie";51498;54886;14006;37492;27;9562;203;199;8;0;3;2;186;37678;186;0;37678;261;153;108;"";37417;16419;20998;45
48;"321400";"stargardzki";"zachodniopomorskie";84212;91185;25086;59125;70;1078;546;528;14;0;2;0;512;59632;511;2;59630;468;234;234;"";59162;26550;32612;75
49;"321500";"szczecinecki";"zachodniopomorskie";54569;59455;18638;35931;41;1410;352;340;13;0;0;0;327;36255;327;2;36253;278;161;117;"";35975;16825;19150;51
49;"321600";"świdwiński";"zachodniopomorskie";34706;35989;13705;21001;27;793;148;145;5;2;1;0;137;21137;137;0;21137;165;88;77;"";20972;10218;10754;37
49;"321700";"wałecki";"zachodniopomorskie";36627;40538;11453;25174;31;788;142;141;2;0;0;1;138;25309;138;3;25306;186;106;80;"";25120;10437;14683;37
48;"321800";"łobeski";"zachodniopomorskie";25226;27963;9174;16052;22;339;136;134;16;0;0;1;117;16169;117;0;16169;122;55;67;"";16047;7793;8254;29
49;"326100";"Koszalin";"zachodniopomorskie";82250;80659;26380;55870;31;1492;697;666;18;1;1;0;646;56506;646;0;56506;430;233;197;"";56076;19766;36310;53
48;"326200";"Szczecin";"zachodniopomorskie";270263;291294;66945;203296;143;4182;2071;1977;36;5;8;4;1924;205183;1924;38;205145;1751;1084;667;"";203394;73873;129521;207
48;"326300";"Świnoujście";"zachodniopomorskie";32911;34480;8661;24247;21;3658;148;136;3;0;2;1;130;24361;130;2;24359;215;131;84;"";24144;8229;15915;27
